{
  "version": 1,
  "id": "dungeon_ember",
  "name": "Ember Caverns - Floor 1",
  "world": "gaia",
  "width": 120,
  "height": 80,
  "tiles": [
    "########################################################################################################################",
    "########################################################################################################################",
    "##....................................................................................................................##",
    "##....................................................................................................................##",
    "##..............########..........####..####..........########..............########..........####..####..........######",
    "##..............########..........####..####..........########..............########..........####..####..........######",
    "##..............########..........####..####..........########..............########..........####..####..........######",
    "##..............########..........####..####..........########..............########..........####..####..........######",
    "##..............^................^^^^^^................^^^^^^................^^^^^^................^^^^^^.............##",
    "##..............^................^^^^^^................^^^^^^................^^^^^^................^^^^^^.............##",
    "##.........^^^^^########.........^####^.####..........########..............########..........####.^####^.........######",
    "##..##########^^##########..##########^.##########..##########..##########..##########..##########.^##########..########",
    "##..##########..##########..##########..##########..##########..##########..##########..##########..##########..########",
    "##..##########..##########..##########..##########..##########..##########..##########..##########..##########..########",
    "##....................................................................................................................##",
    "##....................................................................................................................##",
    "##..##########..##########..##########..##########..##########..##########..##########..##########..##########..########",
    "##..##########..##########..##########..##########..##########..##########..##########..##########..##########..########",
    "##..##########..##########..##########..##########..##########..##########..##########..##########..##########..########",
    "##..##########..##########..##########..##########..##########..##########..##########..##########..##########..########",
    "##....................................................................................................................##",
    "##....................................................................................................................##",
    "##..............########..........####..####..........########..............########..........####..####..........######",
    "##..............########..........####..####..........########..............########..........####..####..........######",
    "##..............########..........####..####..........########..............########..........####..####..........######",
    "##..............########..........####..####..........########..............########..........####..####..........######",
    "##.........^^^^^^................^^^^^^................^^^^^^................^^^^^^................^^^^^^.............##",
    "##.........^^^^^^................^^^^^^................^^^^^^................^^^^^^................^^^^^^.............##",
    "##..##########^^##########..##########^.##########..##########..##########..##########..##########.^##########..########",
    "##..##########^^##########..##########^.##########..##########..##########..##########..##########.^##########..########",
    "##..##########..##########..##########..##########..##########..##########..##########..##########..##########..########",
    "##..##########..##########..##########..##########..##########..##########..##########..##########..##########..########",
    "##....................................................................................................................##",
    "##....................................................................................................................##",
    "##..##########..##########..##########..##########..##########..##########..##########..##########..##########..########",
    "##..##########..##########..##########..##########..##########..##########..##########..##########..##########..########",
    "##..............########..........####..####..........########..............########..........####..####..........######",
    "##..............########..........####..####..........########..............########..........####..####..........######",
    "##....................................................................................................................##",
    "##....................................................................................................................##",
    "##..............########..........####..####..........########..............########..........####..####..........######",
    "##..............########..........####..####..........########..............########..........####..####..........######",
    "##..............########..........####..####..........########..............########..........####..####..........######",
    "##..##########..##########..##########..##########..##########..##########..##########..##########..##########..########",
    "##.........^^^^^^................^^^^^^................^^^^^^................^^^^^^................^^^^^^.............##",
    "##.........^^^^^^................^^^^^^................^^^^^^................^^^^^^................^^^^^^.............##",
    "##..##########^^##########..##########^.##########..##########..##########..##########..##########.^##########..########",
    "##..##########^^##########..##########^.##########..##########..##########..##########..##########.^##########..########",
    "##..##########..##########..##########..##########..##########..##########..##########..##########..##########..########",
    "##..##########..##########..##########..##########..##########..##########..##########..##########..##########..########",
    "##....................................................................................................................##",
    "##....................................................................................................................##",
    "##..............########..........####..####..........########..............########..........####..####..........######",
    "##..............########..........####..####..........########..............########..........####..####..........######",
    "##..............########..........####..####..........########..............########..........####..####..........######",
    "##..............########..........####..####..........########..............########..........####..####..........######",
    "##....................................................................................................................##",
    "##....................................................................................................................##",
    "##..............########..........####..####..........########..............########..........####..####..........######",
    "##..##########..##########..##########..##########..##########..##########..##########..##########..##########..########",
    "##..##########..##########..##########..##########..##########..##########..##########..##########..##########..########",
    "##..##########..##########..##########..##########..##########..##########..##########..##########..##########..########",
    "##.........^^^^^^................^^^^^^................^^^^^^................^^^^^^................^^^^^^.............##",
    "##.........^^^^^^................^^^^^^................^^^^^^................^^^^^^................^^^^^^.............##",
    "##..##########^^##########..##########^.##########..##########..##########..##########..##########.^##########..########",
    "##..##########^^##########..##########^.##########..##########..##########..##########..##########.^##########..########",
    "##..##########..##########..##########..##########..##########..##########..##########..##########..##########..########",
    "##..##########..##########..##########..##########..##########..##########..##########..##########..##########..########",
    "##....................................................................................................................##",
    "##....................................................................................................................##",
    "##..............########..........####..####..........########..............########..........####..####..........######",
    "##..............########..........####..####..........########..............########..........####..####..........######",
    "##..............########..........####..####..........########..............########..........####..####..........######",
    "##..............########..........####..####..........########..............########..........####..####..........######",
    "##....................................................................................................................##",
    "##....................................................................................................................##",
    "##..##########..##########..##########..##########..##########..##########..##########..##########..##########..########",
    "##..##########..##########..##########..##########..##########..##########..##########..##########..##########..########",
    "########################################################################################################################",
    "########################################################################################################################"
  ],
  "legend": {
    "#": {"tile": "wall", "passable": false, "palette": "bright_black"},
    ".": {"tile": "floor", "passable": true, "palette": "yellow"},
    "^": {"tile": "lava", "passable": false, "palette": "bright_red"},
    " ": {"tile": "floor", "passable": true, "palette": "yellow"}
  },
  "encounters": [
    {
      "zone_id": "ember_core",
      "rect": [0, 0, 120, 80],
      "table": "ember_shallows"
    }
  ],
  "encounter_rate": 0.12,
  "events": [],
  "npcs": [],
  "chests": [
    {
      "id": "ember_cache",
      "pos": [10, 10],
      "glyph_closed": "▣",
      "glyph_open": "▢",
      "palette": "bright_yellow",
      "opened_flag": "dungeon.ember_cache_opened",
      "loot": {
        "items": [{"id": "potion", "qty": 2}],
        "equipment": [{"id": "bronze_sword", "qty": 1}],
        "currency": [{"id": "gil", "amount": 45}]
      }
    }
  ],
  "shops": [],
  "allow_save": false,
  "save_points": [[8, 4]],
  "transitions": [
    {
      "id": "exit_ember",
      "pos": [4, 4],
      "target_map": "overworld_gaia",
      "target_pos": [6, 4],
      "return_to_last": true,
      "glyph": ">",
      "palette": "bright_cyan"
    },
    {
      "id": "ember_to_depths",
      "pos": [10, 4],
      "target_map": "dungeon_ember_depths",
      "target_pos": [2, 2],
      "return_to_last": false,
      "glyph": ">",
      "palette": "bright_cyan"
    }
  ]
}
