{
  "version": 1,
  "id": "dungeon_fount",
  "name": "Fount of All Water - Entrance",
  "world": "gaia",
  "width": 60,
  "height": 30,
  "tiles": [
    "############################################################",
    "#############################..#############################",
    "#############################..#############################",
    "#############################..#############################",
    "##########################........##########################",
    "#######################..............#######################",
    "#####################...~~~~~~~~~~....######################",
    "####################...~~~~~~~~~~~~....#####################",
    "###################...~~~~......~~~~...#####################",
    "##################...~~~~........~~~~...####################",
    "##################...~~~~........~~~~...####################",
    "##################...~~~~........~~~~...####################",
    "##################...~~~~........~~~~...####################",
    "##################...~~~~........~~~~...####################",
    "##################...~~~~........~~~~...##########..########",
    "##################...~~~~........~~~~...##########..########",
    "##################...~~~~........~~~~...##########..########",
    "##################...~~~~........~~~~...####################",
    "##################...~~~~........~~~~...####################",
    "##################...~~~~........~~~~...####################",
    "##################...~~~~........~~~~...####################",
    "##################...~~~~........~~~~...####################",
    "###################...~~~~......~~~~...#####################",
    "####################...~~~~~~~~~~~~....#####################",
    "#####################...~~~~~~~~~~....######################",
    "#######################..............#######################",
    "##########################........##########################",
    "#############################..#############################",
    "#############################..#############################",
    "############################################################"
  ],
  "legend": {
    "#": {
      "tile": "wall",
      "passable": false,
      "palette": "bright_black"
    },
    ".": {
      "tile": "floor",
      "passable": true,
      "palette": "bright_green"
    },
    "~": {
      "tile": "water",
      "passable": false,
      "palette": "bright_blue"
    }
  },
  "encounters": [
    {
      "zone_id": "fount_dungeon",
      "rect": [0, 0, 60, 30],
      "table": "fount_dungeon"
    }
  ],
  "encounter_rate": 0.08,
  "events": [],
  "npcs": [
    {
      "id": "fae_engineer",
      "pos": [29, 26],
      "requires_flags": null
    }
  ],
  "chests": [
    {
      "id": "fount_entrance_chest",
      "pos": [50, 15],
      "glyph_closed": "▣",
      "glyph_open": "▢",
      "palette": "bright_yellow",
      "opened_flag": "dungeon.fount_entrance_chest_opened",
      "loot": {
        "items": [{"id": "potion", "qty": 2}],
        "equipment": [],
        "currency": [{"id": "gold", "amount": 50}]
      }
    }
  ],
  "allow_save": false,
  "save_points": [],
  "transitions": [
    {
      "id": "fount_exit",
      "pos": [29, 28],
      "target_map": "overworld_gaia",
      "target_pos": [210, 95],
      "return_to_last": true,
      "glyph": "<",
      "palette": "bright_cyan"
    }
  ],
  "doors": [
    {
      "id": "to_depths_gate",
      "pos": [29, 2],
      "requires_flag": "quest.gale_pass.fount_briefing",
      "locked_text": "A fae ward seals the depths.",
      "locked_event": null,
      "target_map": "dungeon_fount_depths",
      "target_pos": [29, 28],
      "return_to_last": false,
      "glyph": ">",
      "palette": "bright_cyan"
    }
  ],
  "puzzles": [],
  "campfires": []
}
