{
  "version": 1,
  "id": "dungeon_tide",
  "name": "Tide Grotto - Floor 1",
  "world": "gaia",
  "width": 120,
  "height": 80,
  "tiles": [
    "########################################################################################################################",
    "########################################################################################################################",
    "##....................................................................................................................##",
    "##....................................................................................................................##",
    "##..............######............####..............######............####..............######............####..########",
    "##..............######............####..............######............####..............######............####..########",
    "##..............######............####..............######............####..............######............####..########",
    "##..............######............####..............######............####..............######............####..########",
    "##....................................................................................................................##",
    "##....................................................................................................................##",
    "##..##########~~##########..##########~~##########..##########~.##########..##########..##########..##########..########",
    "##..##########~~##########..##########~~##########..##########~.##########..##########..##########..##########..########",
    "##..##########~~##########..##########~~##########..##########~.##########..##########..##########..##########..########",
    "##..##########~~##########..##########~~##########..##########~.##########..##########..##########..##########..########",
    "##....................................................................................................................##",
    "##....................................................................................................................##",
    "##..##########..##########..##########..##########..##########..##########..##########..##########..##########..########",
    "##..##########..##########..##########..##########..##########..##########..##########..##########..##########..########",
    "##..............######............####..............######............####..............######............####..########",
    "##..............######............####..............######............####..............######............####..########",
    "##....................................................................................................................##",
    "##....................................................................................................................##",
    "##..............######............####..............######............####..............######............####..########",
    "##..............######............####..............######............####..............######............####..########",
    "##..##########..##########..##########..##########..##########..##########..##########..##########..##########..########",
    "##..##########..##########..##########..##########..##########..##########..##########..##########..##########..########",
    "##....................................................................................................................##",
    "##....................................................................................................................##",
    "##..##########~~##########..##########~~##########..##########~.##########..##########..##########..##########..########",
    "##..##########~~##########..##########~~##########..##########~.##########..##########..##########..##########..########",
    "##..##########~~##########..##########~~##########..##########~.##########..##########..##########..##########..########",
    "##..##########~~##########..##########~~##########..##########~.##########..##########..##########..##########..########",
    "##....................................................................................................................##",
    "##....................................................................................................................##",
    "##..............######............####..............######............####..............######............####..########",
    "##..............######............####..............######............####..............######............####..########",
    "##..............######............####..............######............####..............######............####..########",
    "##..............######............####..............######............####..............######............####..########",
    "##....................................................................................................................##",
    "##....................................................................................................................##",
    "##..##########..##########..##########..##########..##########..##########..##########..##########..##########..########",
    "##..##########..##########..##########..##########..##########..##########..##########..##########..##########..########",
    "##..##########..##########..##########..##########..##########..##########..##########..##########..##########..########",
    "##..##########..##########..##########..##########..##########..##########..##########..##########..##########..########",
    "##....................................................................................................................##",
    "##....................................................................................................................##",
    "##...........~~~######............####~~~...........######~~~~~.......####.....~~~~~~...######.......~~~~~####..########",
    "##...........~~~######............####~~~...........######~~~~~.......####.....~~~~~~...######.......~~~~~####..########",
    "##...........~~~######............####~~~...........######~~~~~.......####.....~~~~~~...######.......~~~~~####..########",
    "##...........~~~######............####~~~...........######~~~~~.......####.....~~~~~~...######.......~~~~~####..########",
    "##....................................................................................................................##",
    "##....................................................................................................................##",
    "##..##########..##########..##########..##########..##########..##########..##########..##########..##########..########",
    "##..##########..##########..##########..##########..##########..##########..##########..##########..##########..########",
    "##..##########..##########..##########..##########..##########..##########..##########..##########..##########..########",
    "##..##########..##########..##########..##########..##########..##########..##########..##########..##########..########",
    "##....................................................................................................................##",
    "##....................................................................................................................##",
    "##..##########..##########..##########..##########..##########..##########..##########..##########..##########..########",
    "##..##########..##########..##########..##########..##########..##########..##########..##########..##########..########",
    "##..............######............####..............######............####..............######............####..########",
    "##..............######............####..............######............####..............######............####..########",
    "##....................................................................................................................##",
    "##....................................................................................................................##",
    "##...........~~~######............####~~~...........######~~~~~.......####.....~~~~~~...######.......~~~~~####..########",
    "##...........~~~######............####~~~...........######~~~~~.......####.....~~~~~~...######.......~~~~~####..########",
    "##..##########~~##########..##########~~##########..##########~.##########..##########..##########..##########..########",
    "##..##########~~##########..##########~~##########..##########~.##########..##########..##########..##########..########",
    "##....................................................................................................................##",
    "##....................................................................................................................##",
    "##..##########..##########..##########..##########..##########..##########..##########..##########..##########..########",
    "##..##########..##########..##########..##########..##########..##########..##########..##########..##########..########",
    "##..##########..##########..##########..##########..##########..##########..##########..##########..##########..########",
    "##..##########..##########..##########..##########..##########..##########..##########..##########..##########..########",
    "##....................................................................................................................##",
    "##....................................................................................................................##",
    "##..##########..##########..##########..##########..##########..##########..##########..##########..##########..########",
    "##..##########..##########..##########..##########..##########..##########..##########..##########..##########..########",
    "########################################################################################################################",
    "########################################################################################################################"
  ],
  "legend": {
    "#": {"tile": "wall", "passable": false, "palette": "bright_black"},
    ".": {"tile": "floor", "passable": true, "palette": "cyan"},
    "~": {"tile": "water", "passable": false, "palette": "blue"},
    " ": {"tile": "floor", "passable": true, "palette": "cyan"}
  },
  "encounters": [
    {
      "zone_id": "tide_core",
      "rect": [0, 0, 120, 80],
      "table": "tide_shallows"
    }
  ],
  "encounter_rate": 0.12,
  "events": [],
  "npcs": [],
  "puzzles": [
    {
      "id": "tide_shard_north",
      "pos": [8, 3],
      "text": "A Tide shard glows faintly in the damp air.",
      "set_flag": "quest.tide_shards.cave_1",
      "event": "tide_shards_check",
      "glyph": "?",
      "palette": "bright_magenta"
    }
  ],
  "shops": [],
  "allow_save": false,
  "save_points": [[4, 4]],
  "transitions": [
    {
      "id": "exit_tide",
      "pos": [4, 4],
      "target_map": "overworld_gaia",
      "target_pos": [16, 7],
      "return_to_last": true,
      "glyph": ">",
      "palette": "bright_cyan"
    },
    {
      "id": "tide_to_depths",
      "pos": [10, 4],
      "target_map": "dungeon_tide_depths",
      "target_pos": [2, 2],
      "return_to_last": false,
      "glyph": ">",
      "palette": "bright_cyan"
    }
  ]
}
