{
  "version": 1,
  "id": "dungeon_ember",
  "name": "Ember Caverns - Floor 1",
  "hide_name": false,
  "world": "gaia",
  "width": 120,
  "height": 80,
  "loop": {
    "x": false,
    "y": false
  },
  "tiles": [
    "########################################################################################################################",
    "########################################################################################################################",
    "#####......#############################################################################################################",
    "#####......#############################################################################################################",
    "#####......#############################################################################################################",
    "#####......#############################################################################################################",
    "#####......###########################################################################################^#################",
    "#######...........#################################################################################^^^^^^^##############",
    "#######............###############################################################################^^^^^^^^^#############",
    "#######............##############################################################################^^^^^^^^^^^############",
    "########....#......##############################################################################^^^^^^^^^^^############",
    "#############.....###############################################################################^^^^^^^^^^^############",
    "#############......#############################################################################^^^^^^^^^^^^^###########",
    "#############......##############################################################################^^^^^^^^^^^############",
    "###########........##############################################################################^^^^^^^^^^^############",
    "###########..........############################################################################^^^^^^^^^^^############",
    "###########..........#############################################################################^^^^^^^^^#############",
    "###########.............###########################################################################^^^^^^^##############",
    "########...................##########################################################.################^#################",
    "########...................#######################################################.......###############################",
    "########...................######################################################.........##############################",
    "########......##............####################################################...........#############################",
    "#########...####............####################################################...........#############################",
    "##################..........####################################################...........#############################",
    "##################..........#################################################...............############################",
    "##################.............#.....###########################################...........#############################",
    "###################..................###########################################...........#############################",
    "######################...............###########################################...........#############################",
    "#########################............############################################.........##############################",
    "#########################...............##########################################.......###############################",
    "##########################..............#############################################.##################################",
    "##########################..............################################################################################",
    "#########################................###############################################################################",
    "#########################................###############################################################################",
    "#########################.................############################################^#################################",
    "#########################......##.........#########################################^^^^^^^##############################",
    "###############################^#.........########################################^^^^^^^^^#############################",
    "############################^^^^^.........################.#######################^^^^^^^^^#############################",
    "###########################^^^^^^..........############.......####################^^^^^^^^^#############################",
    "##########################^^^^^^...........##########...........#################^^^^^^^^^^^############################",
    "##########################^^^^^^...........#########.............#################^^^^^^^^^#############################",
    "##########################^^^^^^.............#######.............#################^^^^^^^^^#############################",
    "##############^##########^^^^^^^...............#..................################^^^^.^^^^#############################",
    "############^^^^^#########^^^^^^..................................#################.......##############################",
    "############^^^^^#########^^^^^^^.................................################.........#############################",
    "###########^^^^^^^########^^^^^^^..................................###############.........#############################",
    "############^^^^^##########^^^^^^^^^..............................################.........#############################",
    "############^^^^^###########^^^^^^^#..............................###############...........############################",
    "##############^################^####..............................################.........#############################",
    "#####################################............................#################.........#############################",
    "######################################...........................#################.........#############################",
    "######################################..........................###################.......##############################",
    "######################################........................########################.#################################",
    "########################################...#####.............###########################################################",
    "###################################################..........###########################################################",
    "####################################################...........##############################^##########################",
    "########################################################.........##########################^^^^^########################",
    "############################^###########################..........#.....##################^^^^^^^#######################",
    "##########################^^^^^#########################..........#.....##################^^^^^^^#######################",
    "#########################^^^^^^^########################................#################^^^^^^^^^######################",
    "#########################^^^^^^^#########################...............###############...^^^^^^^#######################",
    "########################^^^^^^^^^##################.#######...........#################....^^^^^^#######################",
    "#########################^^^^^^^################.......###...........##################.....^^^^########################",
    "#########################^^^^^^^##############...........#...........##################.....#^#############....#########",
    "##########################^^^^^#############^........................###################.....###########........########",
    "############################^##############^^^...........###.........##################......##......##.........##...###",
    "###########################################^^^.............#...........###...#######..........#.......................##",
    "##########################################^^^^.............###................................#.......................##",
    "###########################################^^^.............####.......................................................##",
    "###########################################^^^^.............####.....................................................###",
    "############################################^^^............#####.........................#.............................#",
    "############################################^^^...........^#####......##.................#............##...............#",
    "############################################^^^^^.......^^^####.....#####............####.............##...............#",
    "#############################################^^^^^^^^^^^^^#####.....########........#####.....####...####....#####...###",
    "#############################################^^^^^^^^^^^^^#####....#########........#####.....#########.......##########",
    "##############################################^^^^^^^^^^^######....######################.....#########.......##########",
    "################################################^^^^^^^####################################...########........##########",
    "###################################################^##################################################.......###########",
    "########################################################################################################################",
    "########################################################################################################################"
  ],
  "legend": {
    " ": {
      "tile": "floor",
      "passable": true,
      "palette": "yellow"
    },
    "^": {
      "tile": "lava",
      "passable": false,
      "palette": "bright_red"
    },
    "#": {
      "tile": "wall",
      "passable": false,
      "palette": "bright_black"
    },
    ".": {
      "tile": "floor",
      "passable": true,
      "palette": "yellow"
    }
  },
  "encounters": [
    {
      "zone_id": "ember_core",
      "rect": [
        0,
        0,
        120,
        80
      ],
      "table": "ember_shallows"
    }
  ],
  "encounter_rate": 0.05,
  "events": [],
  "npcs": [],
  "signs": [],
  "chests": [
    {
      "id": "ember_cache",
      "pos": [
        85,
        18
      ],
      "glyph_closed": "▣",
      "glyph_open": "▢",
      "palette": "bright_yellow",
      "opened_flag": "dungeon.ember_cache_opened",
      "loot": {
        "items": [
          {
            "id": "potion",
            "qty": 2
          }
        ],
        "equipment": [
          {
            "id": "bronze_sword",
            "qty": 1
          }
        ],
        "currency": [
          {
            "id": "gold",
            "amount": 45
          }
        ]
      }
    },
    {
      "id": "ember_cache_ridge",
      "pos": [
        77,
        24
      ],
      "glyph_closed": "▣",
      "glyph_open": "▢",
      "palette": "bright_yellow",
      "opened_flag": "dungeon.ember_cache_ridge_opened",
      "loot": {
        "items": [
          {
            "id": "potion",
            "qty": 1
          },
          {
            "id": "ether",
            "qty": 1
          }
        ],
        "equipment": [],
        "currency": [
          {
            "id": "gold",
            "amount": 60
          }
        ]
      }
    },
    {
      "id": "ember_cache_depths",
      "pos": [
        59,
        69
      ],
      "glyph_closed": "▣",
      "glyph_open": "▢",
      "palette": "bright_yellow",
      "opened_flag": "dungeon.ember_cache_depths_opened",
      "loot": {
        "items": [
          {
            "id": "ether",
            "qty": 1
          }
        ],
        "equipment": [
          {
            "id": "bronze_armor",
            "qty": 1
          }
        ],
        "currency": [
          {
            "id": "gold",
            "amount": 75
          }
        ]
      }
    }
  ],
  "allow_save": false,
  "save_points": [
    [
      105,
      76
    ]
  ],
  "transitions": [
    {
      "id": "exit_ember",
      "pos": [
        6,
        6
      ],
      "target_map": "overworld_gaia",
      "target_pos": [
        50,
        37
      ],
      "label": null,
      "requires_flag": null,
      "cost": null,
      "return_to_last": true,
      "glyph": ">",
      "palette": "bright_cyan"
    },
    {
      "id": "ember_to_depths",
      "pos": [
        112,
        69
      ],
      "target_map": "dungeon_ember_depths",
      "target_pos": [
        2,
        2
      ],
      "label": null,
      "requires_flag": null,
      "cost": null,
      "return_to_last": false,
      "glyph": ">",
      "palette": "bright_cyan"
    },
    {
      "id": "ember_to_core",
      "pos": [
        85,
        30
      ],
      "target_map": "dungeon_ember_core",
      "target_pos": [
        20,
        8
      ],
      "label": null,
      "requires_flag": null,
      "cost": null,
      "return_to_last": false,
      "glyph": ">",
      "palette": "bright_cyan"
    }
  ],
  "vehicles": [],
  "doors": [
    {
      "id": "ember_niche_gate",
      "pos": [
        57,
        64
      ],
      "requires_flag": "dungeon.ember_rune_niche",
      "locked_text": "The rune gate is sealed.",
      "locked_event": null,
      "target_map": null,
      "target_pos": null,
      "return_to_last": false,
      "glyph": "+",
      "palette": "bright_yellow"
    }
  ],
  "puzzles": [
    {
      "id": "ember_rune_niche",
      "pos": [
        79,
        24
      ],
      "requires_flags": null,
      "text": "A rune scar is etched into the basalt, still warm to the touch.",
      "event": null,
      "set_flag": "dungeon.ember_rune_niche",
      "glyph": "?",
      "palette": "bright_magenta"
    },
    {
      "id": "ember_rune_seal",
      "pos": [
        67,
        45
      ],
      "requires_flags": null,
      "text": "A sealed ember plate hums softly behind the stone.",
      "event": null,
      "set_flag": "dungeon.ember_rune_seal",
      "glyph": "?",
      "palette": "bright_magenta"
    }
  ],
  "campfires": []
}
