{
  "version": 1,
  "id": "dungeon_dragon",
  "name": "Skyfang Isle - Floor 1",
  "hide_name": false,
  "world": "gaia",
  "width": 80,
  "height": 120,
  "loop": {
    "x": false,
    "y": false
  },
  "tiles": [
    "################################################################################",
    "################################################################################",
    "#######################################################################.########",
    "#########################################################################...####",
    "#######################################################################.....####",
    "#######################################################################.......##",
    "######..###########################################################...........##",
    "######.############################################################...........##",
    "##..###############################################################.........####",
    "##.################################################################.........####",
    "####################################.##############################.........####",
    "#################################.......##.########################.........####",
    "################################..............#################.............####",
    "###############################................################..............###",
    "###############################.................##########...................###",
    "###############################.................##########...................###",
    "##############################..................##########....................##",
    "###############################..................########....................###",
    "##############################..................#########....................###",
    "###############################.................######.......................###",
    "###############################.................######......................####",
    "###############################................#######...........###.......#####",
    "################################..............########............#####.########",
    "#####################.###########................###..............##############",
    "##################.......#########................................##############",
    "################...........#########..............................##############",
    "###############.............##########...........................###############",
    "###############.............##########...........................###############",
    "##############...............#########........................##################",
    "##############...............######.....................##....##################",
    "##############...............###......................#####...##################",
    "#############........................................######...##################",
    "##############...............###...........####....#############################",
    "##############...............#######.......####....#############################",
    "##############...............######........#####################################",
    "###############.............######.........#####################################",
    "###############.............#####..........#####################################",
    "################...........######.......########################################",
    "##################.......######.........########################################",
    "#####################.#########.........########################################",
    "#############################........###########################################",
    "###########################...........##########################################",
    "###########################...........##########################################",
    "#####################...###...........##########################################",
    "#####################...###...........##########################################",
    "####################.................###########################################",
    "####################................############################################",
    "#################................###############################################",
    "################.................###############################################",
    "###############~.................###############################################",
    "###############~...............#################################################",
    "###############~..............###################~##############################",
    "##############~..............#################~~~~~~~###########################",
    "#############............####################~~~~~~~~~##########################",
    "#############............###################~~~~~~~~~~~#########################",
    "#############............###################~~~~~~~~~~~#########################",
    "############............####################~~~~~~~~~~~#########################",
    "############...........####################~~~~~~~~~~~~~########################",
    "############............####################~~~~~~~~~~~#########################",
    "#############...........####################~~~~~~~~~~~#########################",
    "############............####################~~~~~~~~~~~#########################",
    "############............#####################~~~~~~~~~###############~##########",
    "#########...............######################~~~~~~~~#############~~~~~########",
    "########................######################~~~~~##~#############~~~~~########",
    "#####.................#########################~~~###~############~~~~~~~#######",
    "####.............#.....#######################~~~~##~~#############~~~~~########",
    "##..............##.....######################~~~~~~~~~#############~~~~~########",
    "##.............####....#####################~~~~~~~~~~###############~##########",
    "##...............#####.####################~~~~~~~~~~~##########################",
    "###..............#####..###################~~~~~~~~~~~##########################",
    "###..............######.#####.#############~~~~~~~~~~~##########################",
    "####.............######.##.......#########~~~~~~~~~~~~~#########################",
    "####.............######............########~~~~~~~~~~~##########################",
    "####.............######.............#######~~~~~~~~~~~##########################",
    "####............#######.............#######~~~~~~~~~~~##########################",
    "######..........######...............#######~~~~~~~~~###########################",
    "######..........######...............########~~~~~~~############################",
    "#######.........######...............###########~###############################",
    "#######........######.................##########################################",
    "#######.......########...............###########################################",
    "######........########...............###########################################",
    "######........########...............###########################################",
    "###...........#########.............############################################",
    "##..........###########.............############################################",
    "##............##########...........#############################################",
    "##.............###########.......###############################################",
    "####...........##############.##################################################",
    "###............#################################################################",
    "#.................##############################################################",
    "#.................##############################################################",
    "#.................##############################################################",
    "#...........#....###############################################################",
    "#............###################################################################",
    "#............###################################################################",
    "#...............#########~######################################################",
    "#...............#######~~~~~####################################################",
    "#...............#######~~~~~#######~############################################",
    "##............########~~~~~~~####~~~~~##########################################",
    "##...........##########~~~~~####~~~~~~~#########################################",
    "###..........##########~~~~~####~~~~~~~#########################################",
    "###.........#############~#####~~~~~~~~~########################################",
    "##..........####################~~~~~~~#########################################",
    "##..........####################~~~~~~~#########################################",
    "##.........######################~~~~~##########################################",
    "#####......########################~############################################",
    "######.#########################################################################",
    "######.#########################################################################",
    "######.#########################################################################",
    "######.#########################################################################",
    "######.#...#####################################################################",
    "######.#...#####################################################################",
    "######......####################################################################",
    "######......####################################################################",
    "#######.....####################################################################",
    "#######.....####################################################################",
    "########....####################################################################",
    "########....####################################################################",
    "#########...####################################################################",
    "################################################################################",
    "################################################################################"
  ],
  "legend": {
    "#": {
      "tile": "wall",
      "passable": false,
      "palette": "bright_black"
    },
    ".": {
      "tile": "floor",
      "passable": true,
      "palette": "cyan"
    },
    "~": {
      "tile": "water",
      "passable": false,
      "palette": "blue"
    }
  },
  "encounters": [],
  "encounter_rate": 0.07,
  "events": [],
  "npcs": [],
  "signs": [],
  "chests": [
    {
      "id": "dragon_cache_shelf",
      "pos": [
        13,
        31
      ],
      "glyph_closed": "▣",
      "glyph_open": "▢",
      "palette": "bright_yellow",
      "opened_flag": "dungeon.dragon_cache_shelf_opened",
      "loot": {
        "items": [
          {
            "id": "ether",
            "qty": 2
          }
        ],
        "equipment": [
          {
            "id": "iron_armor",
            "qty": 1
          }
        ],
        "currency": [
          {
            "id": "gold",
            "amount": 140
          }
        ]
      }
    }
  ],
  "allow_save": false,
  "save_points": [
    [
      7,
      112
    ]
  ],
  "transitions": [
    {
      "id": "dragon_exit",
      "pos": [
        73,
        6
      ],
      "target_map": "overworld_gaia",
      "target_pos": [
        128,
        72
      ],
      "label": null,
      "requires_flag": null,
      "cost": null,
      "return_to_last": false,
      "glyph": "<",
      "palette": "bright_cyan"
    },
    {
      "id": "dragon_to_depths",
      "pos": [
        9,
        112
      ],
      "target_map": "dungeon_dragon_depths",
      "target_pos": [
        73,
        6
      ],
      "label": null,
      "requires_flag": null,
      "cost": null,
      "return_to_last": false,
      "glyph": ">",
      "palette": "bright_cyan"
    }
  ],
  "vehicles": [],
  "doors": [
    {
      "id": "dragon_gate_approach",
      "pos": [
        30,
        31
      ],
      "requires_flag": "dungeon.dragon_key_1",
      "locked_text": "The rune gate is sealed.",
      "locked_event": null,
      "target_map": null,
      "target_pos": null,
      "return_to_last": false,
      "glyph": "+",
      "palette": "bright_yellow"
    }
  ],
  "puzzles": [
    {
      "id": "dragon_sigil_entry",
      "pos": [
        42,
        11
      ],
      "requires_flags": null,
      "text": "A storm-scarred sigil burns into your palm.",
      "event": null,
      "set_flag": "dungeon.dragon_sigil_entry",
      "glyph": "?",
      "palette": "bright_magenta"
    },
    {
      "id": "dragon_switch_approach",
      "pos": [
        35,
        83
      ],
      "requires_flags": null,
      "text": "Ancient stone grinds open in the depths.",
      "event": null,
      "set_flag": "dungeon.dragon_key_1",
      "glyph": "?",
      "palette": "bright_magenta"
    }
  ],
  "campfires": []
}
