{
  "version": 1,
  "id": "dungeon_dragon_sanctum",
  "name": "Skyfang Isle - Floor 3",
  "hide_name": false,
  "world": "gaia",
  "width": 120,
  "height": 80,
  "loop": {
    "x": false,
    "y": false
  },
  "tiles": [
    "########################################################################################################################",
    "#######################.........########################################################################################",
    "################...##...........##...##############...##################################################################",
    "################.................#....###########.....##################################################################",
    "################......................#######..........#################################################################",
    "###############.......................#######...........################################################################",
    "#######.................................###.............################################################################",
    "#####....######.........................................################################################################",
    "###........####..........................................###############################################################",
    "##.........####...........................................##############################################################",
    "##.........####...........................................##############################################################",
    "##.......########.........................................##############################################################",
    "####################........#.......#.......................#...########################################################",
    "######################....##........#..............................#####################.###############################",
    "#######################...##.......######..........................~#################.......############################",
    "#######################...##....##########..........#...............~~~############...........##########################",
    "############################....##############......##..................##########.............#########################",
    "#############################...#######################..................#########.............#########################",
    "#####################################################....................########...............########################",
    "####################################################.....................########...............########################",
    "####################################################.......................######...............########################",
    "#########################################.##########.........................###.................#######################",
    "######################~###############.......#####.....#.....................####...............########################",
    "####################~~~~~###########...............#####......#..............####...............########################",
    "####################~~~~~##########.............################...........######...............########################",
    "###################~~~~~~~#########.............###################........#######.............#########################",
    "####################~~~~~#########...............##################........#######.............#########################",
    "####################~~~~~#########...............##################............####...........##########################",
    "######################~###########...............##################............######.......############################",
    "#################################.................##################............########.###############################",
    "##################################...............####################...........########.############.#.################",
    "###################~##############...............#####################............######.#########.........#############",
    "#################~~~~~############...............#####################............#####...#######...........############",
    "################~~~~~~~############.............#########################...........###...######.............###########",
    "################~~~~~~~############.............#########################............##...#####..............###########",
    "###############~~~~~~~~~############...........##########################.............#....####..............###########",
    "################~~~~~~~###############.......#############################.................###................##########",
    "################~~~~~~~##################.#################################....#...........###...............###########",
    "#################~~~~~##########################################################.............................###########",
    "###################~############################################################.............................###########",
    "###################################################################################.........................############",
    "###################################################################################.........................############",
    "################################################~##################################..........................###########",
    "#############################################~~~~~~~##########~#########################....................############",
    "############################################~~~~~~~~~######~~~~~~~######################....................############",
    "###########################################~~~~~~~~~~~####~~~~~~~~~#####################....................############",
    "###########################################~~~~~~~~~~~~#~~~~~~~~~~~~####################.........#.........#############",
    "###########################################~~~~~~~~~~~~~~~~~~~~~~~~~##################...........##.......##############",
    "##########################################~~~~~~~~~~~~~~~~~~~~~~~~~~##################...........#####.#################",
    "###########################################~~~~~~~~~~~~~~~~~~~~~~~~~~#################..........########################",
    "###########################################~~~~~~~~~~~##~~~~~~~~~~~~##################..........########################",
    "###########################################~~~~~~~~~~~###~~~~~~~~~~~####################........########################",
    "############################################~~~~~~~~~~~##~~~~~~~~~~~####################.........#######################",
    "#############################################~~~~~~~~~~~~~~~~~~~~~~######################........#######################",
    "################################################~##########~~~~~~~########################...........###################",
    "##############################################################~###########################...........###################",
    "#####################.#####################################################################..........###################",
    "##################.......##################################################################............#################",
    "#################.........################################################################................##############",
    "################...........#############################################################..................##############",
    "################...........#############################################################..................##############",
    "################...........#############################################################..................##############",
    "###############.............################################################################..............##############",
    "################...........#################################################################................############",
    "################...........#################################################################................############",
    "################...........###################################################################....#.........############",
    "#################.........#############################~###########################################.........############",
    "##################.......############################~~~~~#########################################............#########",
    "#####################.###############################~~~~~########################################...............#######",
    "####################################################~~~~~~~#######################################................######",
    "#####################################################~~~~~########################################................######",
    "#####################################################~~~~~#######################################...................####",
    "#######################################################~##########################################..................####",
    "##################################################################################################...................###",
    "##################################################################################################...................###",
    "###################################################################################################.................####",
    "####################################################################################################.......#####...#####",
    "#######################################################################################################.########...#####",
    "########################################################################################################################",
    "########################################################################################################################"
  ],
  "legend": {
    "#": {
      "tile": "wall",
      "passable": false,
      "palette": "bright_black"
    },
    "~": {
      "tile": "water",
      "passable": false,
      "palette": "blue"
    },
    ".": {
      "tile": "floor",
      "passable": true,
      "palette": "cyan"
    }
  },
  "encounters": [
    {
      "zone_id": "dragon_sanctum",
      "rect": [
        0,
        0,
        120,
        80
      ],
      "table": "dragon_sanctum"
    }
  ],
  "encounter_rate": 0.12,
  "events": [],
  "npcs": [],
  "signs": [],
  "chests": [
    {
      "id": "dragon_sanctum_cache_reef",
      "pos": [
        15,
        62
      ],
      "glyph_closed": "▣",
      "glyph_open": "▢",
      "palette": "bright_yellow",
      "opened_flag": "dungeon.dragon_sanctum_cache_reef_opened",
      "loot": {
        "items": [
          {
            "id": "ether",
            "qty": 2
          },
          {
            "id": "antidote",
            "qty": 2
          }
        ],
        "equipment": [
          {
            "id": "steel_armor",
            "qty": 1
          }
        ],
        "currency": [
          {
            "id": "gold",
            "amount": 190
          }
        ]
      }
    },
    {
      "id": "dragon_sanctum_cache_shelf",
      "pos": [
        88,
        13
      ],
      "glyph_closed": "▣",
      "glyph_open": "▢",
      "palette": "bright_yellow",
      "opened_flag": "dungeon.dragon_sanctum_cache_shelf_opened",
      "loot": {
        "items": [
          {
            "id": "potion",
            "qty": 3
          },
          {
            "id": "ether",
            "qty": 1
          }
        ],
        "equipment": [],
        "currency": [
          {
            "id": "gold",
            "amount": 180
          }
        ]
      }
    }
  ],
  "allow_save": false,
  "save_points": [],
  "transitions": [
    {
      "id": "dragon_sanctum_up",
      "pos": [
        113,
        73
      ],
      "target_map": "dungeon_dragon_depths",
      "target_pos": [
        9,
        112
      ],
      "label": null,
      "requires_flag": null,
      "cost": null,
      "return_to_last": false,
      "glyph": "<",
      "palette": "bright_cyan"
    },
    {
      "id": "dragon_sanctum_down",
      "pos": [
        7,
        9
      ],
      "target_map": "dungeon_dragon_heart",
      "target_pos": [
        113,
        73
      ],
      "label": null,
      "requires_flag": null,
      "cost": null,
      "return_to_last": false,
      "glyph": ">",
      "palette": "bright_cyan"
    }
  ],
  "vehicles": [],
  "doors": [
    {
      "id": "dragon_sanctum_gate",
      "pos": [
        88,
        30
      ],
      "requires_flag": "dungeon.dragon_key_3",
      "locked_text": "The wardstone refuses to yield.",
      "locked_event": null,
      "target_map": null,
      "target_pos": null,
      "return_to_last": false,
      "glyph": "+",
      "palette": "bright_yellow"
    },
    {
      "id": "dragon_sanctum_trap_return",
      "pos": [
        19,
        9
      ],
      "requires_flag": null,
      "locked_text": null,
      "locked_event": null,
      "target_map": "dungeon_dragon",
      "target_pos": [
        6,
        6
      ],
      "return_to_last": false,
      "glyph": "+",
      "palette": "bright_yellow"
    }
  ],
  "puzzles": [
    {
      "id": "dragon_sanctum_lens",
      "pos": [
        80,
        21
      ],
      "requires_flags": null,
      "text": "Lightning arcs between crystal spines.",
      "event": null,
      "set_flag": "dungeon.dragon_sanctum_lens",
      "glyph": "?",
      "palette": "bright_magenta"
    },
    {
      "id": "dragon_sanctum_switch",
      "pos": [
        36,
        35
      ],
      "requires_flags": [
        "dungeon.dragon_key_1",
        "dungeon.dragon_key_2"
      ],
      "text": "A distant gate opens in the inner sanctum.",
      "event": null,
      "set_flag": "dungeon.dragon_key_3",
      "glyph": "?",
      "palette": "bright_magenta"
    }
  ],
  "campfires": []
}
