{
  "version": 1,
  "id": "dungeon_dragon_heart",
  "name": "Skyfang Isle - Floor 4",
  "hide_name": false,
  "world": "gaia",
  "width": 120,
  "height": 80,
  "loop": {
    "x": false,
    "y": false
  },
  "tiles": [
    "########################################################################################################################",
    "########################################################################################################################",
    "###########.......##################################################^###################################################",
    "##########........########...####################################^^^^^^^################################################",
    "##########.......#########.....######################....######^^^^^^^^^^^##############################################",
    "##########.......#########.....#####........#########....#####^^^^^^^^^^^^^#############################################",
    "###...#####....####...####....######........########.....#####^^^^^^^^^^^^^#############################################",
    "#...............##............#####............#####.....####^^^.......^^^^^############################################",
    "#...............##............#.................##......#####^...........^^^############################################",
    "#.............................#.........................#####............^^^############################################",
    "###.....................................................####.............^^^^###########################################",
    "##...........................##..........................####.............^^^###########################################",
    "##.......................####^^...........................###.............^^^^##########################################",
    "##.......................###^^^.....#######...###...........#.............^^^###########################################",
    "###...##.........##......##^^....##################.........###...........^^^##############^############################",
    "########........###########^^...###################........................^#############^^^^^##########################",
    "#########....#############^^.....##################...........#...........##############^^^^^^^#########################",
    "########################^^^^.....##################...........###.......################^^^^^^^#########################",
    "#######################^^^^^^....#################...........#######.##################^^^^^^^^^########################",
    "#######################^^^^^^^...################..............#########################^^^^^^^#########################",
    "######################^^^^^^^^^#################................########################^^^^^^^#########################",
    "#######################^^^^^^^##################.....#..........#########################^^^^^##########################",
    "#######################^^^^^^^###################...##..........###########################^############################",
    "########################^^^^^##########################.........########################################################",
    "##########################^##############################...........####################################################",
    "###########################################################..........###################################################",
    "###########################################################.............#####...########################################",
    "#################################.########################........................######################################",
    "##############################.......###################..........................######################################",
    "#############################.........#################...........................######################################",
    "#############################.........#################............................#####################################",
    "#############################.........################..............................####^################^##############",
    "############################...........###############..............................#^^^^^^^###########^^^^^############",
    "#############################.........################..............................^^^^^^^^^##########^^^^^############",
    "#############################.........###############..................................^^^^^^^########^^^^^^^###########",
    "#############################.........################.................................^^^^^^^#########^^^^^############",
    "##############################.......#################..................................^^^^^^#########^^^^^############",
    "#############################^^^^.^^^^################..................#...............^^^^^^^##########^##############",
    "#############################^^^^^^^^^#################.............#######.............^^^^^^##########################",
    "#############################^^^^^^^^^#################.............#########...........^^^^^^##########################",
    "############################^^^^^^^^^^^#################...........##########...........^^^^^^##########################",
    "#############################^^^^^^^^^####################.......############..........^^^^^^###########################",
    "#############################^^^^^^^^^#######################.################.........^^^^^############################",
    "#############################^^^^^^^^^########################################.........#^###############################",
    "##############################^^^^^^^#########################################.........##..#############################",
    "#################################^############################################...............###########################",
    "###############################################################################...............##########################",
    "###############################################################################................#########################",
    "################################################################################..............##########################",
    "##################################.#############################################..............##########################",
    "###############################.......##########################################...............#########################",
    "##############################.........############################################............#########################",
    "#############################...........############################################..............######################",
    "#############################...........##############################################...............###################",
    "#############################...........#################################################.............##################",
    "############################...............################################################...........##################",
    "#############################...........####################################################..........##################",
    "#############################...........####################################################............####...#########",
    "#############################...........####################################################............##......########",
    "##############################.........######################################################...................########",
    "###############################.......#######################################################...................########",
    "#################^################.###########################################################..................########",
    "##############^^^^^^^###########################################################################.............###########",
    "#############^^^^^^^^^#############################################################################..........###########",
    "############^^^^^^^^^^^############################################################################..........###########",
    "############^^^^^^^^^^^##############################################################################........###########",
    "############^^^^^^^^^^^##############################################################################......#############",
    "###########^^^^^^^^^^^^^#############################################################################......#############",
    "############^^^^^^^^^^^###############################################################################.....#############",
    "############^^^^^^^^^^^##############################################################################......#....########",
    "############^^^^^^^^^^^##############################################################################............#######",
    "#############^^^^^^^^^###############################################################################............#######",
    "##############^^^^^^^####################################################################################........#######",
    "#################^###########################################################################################......#####",
    "#############################################################################################################......#####",
    "#############################################################################################################......#####",
    "#############################################################################################################......#####",
    "##############################################################################################################....######",
    "########################################################################################################################",
    "########################################################################################################################"
  ],
  "legend": {
    "#": {
      "tile": "wall",
      "passable": false,
      "palette": "bright_black"
    },
    "^": {
      "tile": "lava",
      "passable": false,
      "palette": "bright_red"
    },
    ".": {
      "tile": "floor",
      "passable": true,
      "palette": "yellow"
    }
  },
  "encounters": [
    {
      "zone_id": "dragon_heart",
      "rect": [
        0,
        0,
        120,
        80
      ],
      "table": "dragon_heart"
    }
  ],
  "encounter_rate": 0.14,
  "events": [],
  "npcs": [
    {
      "id": "boss_dragon",
      "pos": [
        14,
        3
      ],
      "script": null,
      "requires_flags": null
    },
    {
      "id": "boss_dragon_after",
      "pos": [
        14,
        3
      ],
      "script": null,
      "requires_flags": [
        "dungeon.dragon_cleared"
      ]
    }
  ],
  "signs": [],
  "chests": [
    {
      "id": "dragon_heart_cache",
      "pos": [
        60,
        10
      ],
      "glyph_closed": "▣",
      "glyph_open": "▢",
      "palette": "bright_yellow",
      "opened_flag": "dungeon.dragon_heart_cache_opened",
      "loot": {
        "items": [
          {
            "id": "ether",
            "qty": 3
          }
        ],
        "equipment": [
          {
            "id": "mythril_sword",
            "qty": 1
          }
        ],
        "currency": [
          {
            "id": "gold",
            "amount": 240
          }
        ]
      }
    }
  ],
  "allow_save": false,
  "save_points": [
    [
      19,
      9
    ]
  ],
  "transitions": [
    {
      "id": "dragon_heart_up",
      "pos": [
        113,
        73
      ],
      "target_map": "dungeon_dragon_sanctum",
      "target_pos": [
        7,
        9
      ],
      "label": null,
      "requires_flag": null,
      "cost": null,
      "return_to_last": false,
      "glyph": "<",
      "palette": "bright_cyan"
    }
  ],
  "vehicles": [],
  "doors": [
    {
      "id": "dragon_heart_gate",
      "pos": [
        30,
        10
      ],
      "requires_flag": "dungeon.dragon_key_4",
      "locked_text": "The final rune gate glows with old malice.",
      "locked_event": null,
      "target_map": null,
      "target_pos": null,
      "return_to_last": false,
      "glyph": "+",
      "palette": "bright_yellow"
    },
    {
      "id": "dragon_heart_trap_return",
      "pos": [
        11,
        5
      ],
      "requires_flag": null,
      "locked_text": null,
      "locked_event": null,
      "target_map": "dungeon_dragon",
      "target_pos": [
        6,
        6
      ],
      "return_to_last": false,
      "glyph": "+",
      "palette": "bright_yellow"
    }
  ],
  "puzzles": [
    {
      "id": "dragon_heart_switch",
      "pos": [
        68,
        18
      ],
      "requires_flags": [
        "dungeon.dragon_key_3"
      ],
      "text": "The heart sigil fractures and the final gate opens.",
      "event": null,
      "set_flag": "dungeon.dragon_key_4",
      "glyph": "?",
      "palette": "bright_magenta"
    }
  ],
  "campfires": []
}
