{
  "version": 1,
  "id": "dungeon_dragon_depths",
  "name": "Skyfang Isle - Floor 2",
  "hide_name": false,
  "world": "gaia",
  "width": 80,
  "height": 120,
  "loop": {
    "x": false,
    "y": false
  },
  "tiles": [
    "################################################################################",
    "################################################################################",
    "################################################################################",
    "################################################################################",
    "################################################################################",
    "#########################################################################.....##",
    "#########################################################################.....##",
    "######################################################################........##",
    "##########################################################....#######.........##",
    "#########################################################.....#######.........##",
    "#########################################################.....#######.........##",
    "##################################^######################.........###....#######",
    "################################^^^^^#####################........####...#######",
    "################################^^^^^#####################...............#######",
    "###############################^^^^^^^#####################..............#######",
    "################################^^^^^######################..............#######",
    "################################^^^^^####################................#######",
    "##################################^######################................#######",
    "######################################################..............#...########",
    "#####################################################............###############",
    "#####################################################............###############",
    "#####################################################..........#################",
    "####################################################...........#################",
    "####################################################...........#################",
    "##################^#################################..........##################",
    "################^^^^^################^#########.##............##################",
    "###############^^^^^^^############^^^^^^^#####...............###################",
    "###############^^^^^^^###########^^^^^^^^^###..............#####################",
    "##############^^^^^^^^^#########^^^^^^^^^^^##...........########################",
    "###############^^^^^^^##########^^^^^^^^^^^#...........#########################",
    "###############^^^^^^^##########^^^^^^^^^^^#...........#########################",
    "################^^^^^##########^^^^^^^^^^^^^#.........##########################",
    "##################^#############^^^^.....^^##.........##########################",
    "################################^^....................##########################",
    "################################^^...................###########################",
    "#################################^...................###########################",
    "###############################.....................############################",
    "##############################.....................#############################",
    "###########################........................#############################",
    "###########################........................#############################",
    "##########################......................################################",
    "##########################....................##################################",
    "############^#############................######################################",
    "##########^^^^^############............#########################################",
    "#######^^^^^^^^^###########............#########################################",
    "#####^^^^^^^^^^.###########...........##########################################",
    "####^^^^^^^......##########...........##########################################",
    "####^^^^.........##########..........###########################################",
    "###^^^^^..........########............##########################################",
    "###^^^^...........########............##########################################",
    "###^^^^...........########............##########################################",
    "##^^^^^............######.............##########################################",
    "###^^^^...........######................########################################",
    "###^^^^...........######.................#######################################",
    "###^^^^...........######.................#######################################",
    "####^^^..........#######..................######################################",
    "####^^^^.........###......................######################################",
    "#####^^^......#.###.......................######################################",
    "#######^^.....#...#........................#####################################",
    "##########.####...........................######################################",
    "#############.............................######################################",
    "#############............##...............######################################",
    "############.............###.............#######################################",
    "####....###.............####.............#######################################",
    "####....................#####...........########################################",
    "####...................########.......##########################################",
    "####.................#############.#############################################",
    "######................##########################################################",
    "########...............#########################################################",
    "########......####.....#########################################################",
    "#########.....#####....#########################################################",
    "#########....#######..##########################################################",
    "########.....###################################################################",
    "#######......###################################################################",
    "#######.......##################################################################",
    "#######.......##################################################################",
    "#####.........##################################################################",
    "#####........####################...............#######.########################",
    "#####........###################.......#######....#####.########################",
    "#####........###################..############....#####.########################",
    "#####........###################..##############...........#####################",
    "#####........###################.#######^#######............####################",
    "#####........################.......#^^^^^^^######...........###################",
    "#####........###############.........^^^^^^^^#####...........###################",
    "#######.......##############.........^^^^^^^^#####...........###################",
    "########......##############.........^^^^^^^^####.............##################",
    "########......#############...........^^^^^^^^####...........###################",
    "########.......#.....................^^^^^^^^#####...........###################",
    "########............########.........^^^^^^^^#####...........###################",
    "####....##..........^#######.........^^^^^^^^######.........####################",
    "####...............^^^^######.......#^^^^^^^########.......#####################",
    "###...............^^^^^^########.#######^##############.########################",
    "###.............#^^^^^^^########################################################",
    "###...........##^^^^^^^^^#######################################################",
    "#######.....#####^^^^^^^########################################################",
    "#######........##^^^^^^^########################################################",
    "#######........###^^^^^############################################^############",
    "#######........#####^###########################################^^^^^^^#########",
    "######.........################################################^^^^^^^^^########",
    "######.........###############################################^^^^^^^^^^^#######",
    "######.........###############################################^^^^^^^^^^^#######",
    "#######.......################################################^^^^^^^^^^^#######",
    "##..#####.....###############################################^^^^^^^^^^^^^######",
    "##....###......###############################################^^^^^^^^^^^#######",
    "##....#.........##############################################^^^^^^^^^^^#######",
    "##..............##############################################^^^^^^^^^^^#######",
    "##..............###############################################^^^^^^^^^########",
    "##...............###############################################^^^^^^^#########",
    "##...............##################################################^############",
    "###...#..........###############################################################",
    "#######..........###############################################################",
    "#######.........################################################################",
    "#######.......##################################################################",
    "#######.......##################################################################",
    "######.........#################################################################",
    "######.........#################################################################",
    "######.........#################################################################",
    "#######...#...##################################################################",
    "#######...######################################################################",
    "################################################################################"
  ],
  "legend": {
    "^": {
      "tile": "lava",
      "passable": false,
      "palette": "bright_red"
    },
    "#": {
      "tile": "wall",
      "passable": false,
      "palette": "bright_black"
    },
    ".": {
      "tile": "floor",
      "passable": true,
      "palette": "yellow"
    }
  },
  "encounters": [
    {
      "zone_id": "dragon_depths",
      "rect": [
        0,
        0,
        80,
        120
      ],
      "table": "dragon_depths"
    }
  ],
  "encounter_rate": 0.1,
  "events": [],
  "npcs": [],
  "signs": [],
  "chests": [
    {
      "id": "dragon_depths_cache",
      "pos": [
        61,
        85
      ],
      "glyph_closed": "▣",
      "glyph_open": "▢",
      "palette": "bright_yellow",
      "opened_flag": "dungeon.dragon_depths_cache_opened",
      "loot": {
        "items": [
          {
            "id": "ether",
            "qty": 2
          }
        ],
        "equipment": [
          {
            "id": "steel_sword",
            "qty": 1
          }
        ],
        "currency": [
          {
            "id": "gold",
            "amount": 170
          }
        ]
      }
    },
    {
      "id": "dragon_depths_cache_ridge",
      "pos": [
        55,
        77
      ],
      "glyph_closed": "▣",
      "glyph_open": "▢",
      "palette": "bright_yellow",
      "opened_flag": "dungeon.dragon_depths_cache_ridge_opened",
      "loot": {
        "items": [
          {
            "id": "potion",
            "qty": 2
          },
          {
            "id": "ether",
            "qty": 1
          }
        ],
        "equipment": [],
        "currency": [
          {
            "id": "gold",
            "amount": 155
          }
        ]
      }
    }
  ],
  "allow_save": false,
  "save_points": [],
  "transitions": [
    {
      "id": "dragon_depths_up",
      "pos": [
        73,
        6
      ],
      "target_map": "dungeon_dragon",
      "target_pos": [
        9,
        112
      ],
      "label": null,
      "requires_flag": null,
      "cost": null,
      "return_to_last": false,
      "glyph": "<",
      "palette": "bright_cyan"
    },
    {
      "id": "dragon_depths_down",
      "pos": [
        9,
        112
      ],
      "target_map": "dungeon_dragon_sanctum",
      "target_pos": [
        113,
        73
      ],
      "label": null,
      "requires_flag": null,
      "cost": null,
      "return_to_last": false,
      "glyph": ">",
      "palette": "bright_cyan"
    }
  ],
  "vehicles": [],
  "doors": [
    {
      "id": "dragon_depths_gate",
      "pos": [
        15,
        57
      ],
      "requires_flag": "dungeon.dragon_key_2",
      "locked_text": "A draconic seal bars the ascent.",
      "locked_event": null,
      "target_map": null,
      "target_pos": null,
      "return_to_last": false,
      "glyph": "+",
      "palette": "bright_yellow"
    },
    {
      "id": "dragon_depths_trap_return",
      "pos": [
        5,
        108
      ],
      "requires_flag": null,
      "locked_text": null,
      "locked_event": null,
      "target_map": "dungeon_dragon",
      "target_pos": [
        6,
        6
      ],
      "return_to_last": false,
      "glyph": "+",
      "palette": "bright_yellow"
    }
  ],
  "puzzles": [
    {
      "id": "dragon_depths_switch",
      "pos": [
        55,
        79
      ],
      "requires_flags": null,
      "text": "The fang rune flashes and a heavy lock yields.",
      "event": null,
      "set_flag": "dungeon.dragon_key_2",
      "glyph": "?",
      "palette": "bright_magenta"
    },
    {
      "id": "dragon_depths_brand",
      "pos": [
        10,
        59
      ],
      "requires_flags": null,
      "text": "The floor hums with ancient heat.",
      "event": null,
      "set_flag": "dungeon.dragon_depths_brand",
      "glyph": "?",
      "palette": "bright_magenta"
    }
  ],
  "campfires": []
}
